{
    "grid":[[ 0, 0, 0, 0, 1, 0, 0, 0],
            [ 0,-2, 0, 0, 0, 0,-2, 0],
            [ 0,-2, 0, 0, 0, 0,-2, 0],
            [-1, 0, 0, 0, 0, 0, 0,-1],
            [-2,-2,-2, 0, 0,-2,-2,-2],
            [10, 0,-1, 0, 0, 0,-1,10],
            [-2,-2,-2, 0, 0,-2,-2,-2],
            [ 0, 0, 0,-1,-1, 0, 0,10]],
    "theme": 0,
    "stars":[3,4,5],
    "win":{
        "condition": 0,
        "spot": [3.0, 0.0]
    },
    "enemies": []
}