{
    "grid":[[ 1,-1, 0, 0, 0, 0, 0, 0, 0,-1, 0],
            [-1,-2, 0,-2, 0,-2, 0,-2, 0,-2,-1],
            [ 0, 0, 0, 0, 0, 0, 0, 0, 0, 0, 0],
            [ 0,-2, 0,-2, 0,-2, 0,-2, 0,-2, 0],
            [ 0, 0, 0, 0, 0, 0, 0, 0, 0, 0, 0],
            [ 0,-2, 0,-2, 0,-2, 0,-2, 0,-2, 0],
            [ 0, 0, 0, 0, 0, 0, 0, 0, 0, 0, 0],
            [ 0,-2, 0,-2, 0,-2, 0,-2, 0,-2, 0],
            [ 0, 0, 0, 0, 0, 0, 0, 0, 0, 0, 0],
            [-1,-2, 0,-2, 0,-2, 0,-2, 0,-2,-1],
            [ 0,-1, 0, 0, 0, 0, 0, 0, 0,-1, 0]],
    "models":{
    "bricks": "assets/models/bricks.obj",
    "undestroyable": "assets/models/undestroyable.obj"},
    "sun":{
        "pos":[20.0, 20.0, 20.0],
        "color":[0.682, 0.356, 0.803]
    },
    "win":{
        "condition": 0,
        "spot": [5.0, 0.0]
    },
    "enemies": [{
        "pos": [0, 10],
        "type": 0
    }
    ]
}